40 40
########################################
#......................................#
#......................................#
#......................................#
#......................................#
#..............#########...............#
#..................###.................#
#.....................####.............#
#......................................#
#......................................#
#..........##########..................#
#..........#...........................#
#......................................#
#......................................#
#......................................#
#.............#........................#
#.............#........................#
#.............#........................#
#............###.......................#
#......................................#
#......................................#
#......##.......#.....#...#...####.....#
#.....#..#.....#.#....#...#...####.....#
#.....#..#....#####...#####...#..#.....#
#....######..#.....#..#...#..#...#.....#
#........................##............#
#..........####..####..#...##..........#
#..........#.....#.....#..#.#..........#
#..........#.....###...#.#..#..........#
#..........#.....#.....##...#..........#
#..........#.....####..#....#..........#
#......................................#
#......................................#
#......................................#
#......................................#
#......................................#
#....#.#.#.#.#.#.#.#.#.#.#.#.#.#.#.#.#.#
#......................................#
#......................................#
########################################